##################
#     #F        R#
#     #           
#  R  ####       #
#               R#
#F              C#
##################