##################
#     #         R#
#     #          #
#     #           
#  R  ####       #
#               R#
#    F          C#
##################