##################
#     #          #
#     #           
#  R  ####       #
#   F            #
#               C#
##################