##################
#     #          #
#     #          #
#  R  ####       #
#   F            #
#               C#
##################